████████████████████
█·····█······×·····█
█·····█··████··█████   
█████··×···██··██··█
█······██··██··██··█
█×·██████████×·██··█
█··█···×···········█
████████████████████
